#######
#.@ # #
#$*   #
#     #
#     #
#  *  #
#######