######
#.@  #
#$   #
#    #
######