#######
#@$.# #
#*    #
#     #
#     #
#  *  #
#######